0 0 0 0 0 0 0 0 0 0 0 0 0 0 0 0 0 0 0 0 0 0 0 0 0 5 3 3 3 3 3 3 3 3 3 3 3 3 3 3 19 19 20 20 20 20 20 20 20 20 
0 0 0 0 0 0 0 0 0 0 0 0 0 0 0 0 0 0 0 0 0 0 0 0 0 5 3 3 3 3 3 3 3 3 3 3 3 3 3 3 3 19 19 19 19 19 19 19 19 20 
0 0 0 0 0 0 0 0 0 0 0 0 0 0 0 0 0 0 0 0 0 0 0 0 0 5 3 3 3 3 3 3 3 3 3 3 3 3 3 3 3 3 3 3 3 1 1 1 19 20 
0 0 0 0 0 0 0 0 0 0 0 0 0 0 0 0 0 0 0 0 0 0 0 0 0 5 3 3 3 3 3 3 3 3 3 3 3 3 3 3 3 3 3 3 1 1 1 3 19 20 
0 0 0 0 0 0 0 0 0 0 0 0 0 0 0 0 0 0 0 0 0 0 0 0 0 5 3 3 3 3 3 3 3 3 3 3 3 3 3 3 3 3 3 1 1 1 3 3 19 20 
0 0 0 0 0 0 0 0 0 0 0 0 0 0 0 0 0 0 0 0 0 0 0 0 0 5 3 3 3 3 3 3 3 3 3 3 3 3 3 3 3 3 1 1 1 3 3 3 19 20 
0 0 0 0 0 0 0 0 0 0 0 0 0 0 0 0 0 0 0 0 0 0 0 0 0 5 3 3 3 3 3 3 3 3 3 3 3 3 3 3 1 1 1 1 3 3 3 3 19 19 
0 0 0 0 0 0 0 0 0 14 12 12 12 12 12 12 12 12 12 12 12 12 12 12 12 5 3 3 3 3 3 3 3 3 3 3 3 3 1 1 1 1 3 3 3 3 3 3 3 19 
0 0 0 0 0 0 0 0 0 10 5 5 5 5 5 5 5 5 5 5 5 5 19 19 19 5 3 3 3 3 3 3 3 3 3 3 3 1 1 1 1 1 3 3 3 3 3 3 3 3 
0 0 0 0 0 0 0 0 0 10 5 5 5 5 5 5 5 5 5 19 19 19 19 19 19 5 3 3 3 3 3 3 3 3 3 3 1 1 1 1 3 3 3 3 3 3 3 3 3 3 
0 0 0 0 0 0 0 0 0 10 5 5 5 5 5 5 5 19 19 19 19 19 19 19 3 5 3 3 3 3 3 3 3 3 1 1 1 1 3 3 3 3 3 3 3 3 3 3 3 3 
0 0 0 0 0 0 0 0 0 10 5 5 19 19 19 5 19 19 3 3 3 19 19 3 3 5 3 3 3 3 3 3 1 1 1 1 3 3 3 3 3 3 3 3 3 3 3 3 3 3 
0 0 0 0 0 0 0 0 0 10 19 19 19 19 3 3 19 19 3 3 3 3 3 3 2 5 2 3 3 3 1 1 1 1 3 3 3 3 3 3 3 3 3 3 3 3 3 3 3 3 
0 0 0 0 0 0 0 0 0 10 5 19 19 3 3 3 3 19 19 19 3 3 19 19 2 5 2 3 1 1 1 1 3 3 3 3 3 3 3 3 3 3 3 3 3 3 3 3 3 3 
0 0 0 0 0 0 0 0 0 10 5 19 19 3 3 3 19 19 19 19 19 19 19 19 2 5 2 1 1 1 3 3 3 3 3 3 3 3 3 3 3 3 3 3 3 3 3 3 3 3 
0 0 0 0 0 0 0 0 0 10 5 5 19 3 19 19 19 19 19 19 19 19 19 19 2 5 1 1 1 1 3 3 3 3 3 3 3 3 3 3 3 3 3 3 3 3 3 3 3 3 
0 0 0 0 0 0 0 0 0 10 5 5 19 19 19 5 19 19 19 19 19 19 19 19 2 5 1 1 3 3 3 3 3 3 3 3 3 3 3 3 3 3 3 3 3 3 3 3 3 3 
0 0 0 0 0 0 0 0 0 10 5 5 5 5 5 19 19 19 19 6 7 7 7 7 7 5 7 7 7 7 7 8 3 3 3 3 3 3 3 3 3 3 3 3 3 3 3 3 3 3 
0 0 0 0 0 0 0 0 0 10 5 5 5 5 19 19 19 19 19 9 3 3 3 3 2 5 2 3 3 3 3 10 3 3 3 3 3 3 3 3 3 3 3 3 3 3 3 3 3 3 
0 0 0 0 0 0 0 0 0 10 5 5 5 19 19 19 19 19 19 9 3 3 3 3 2 5 2 3 3 3 3 10 3 3 3 3 3 3 3 3 3 3 3 3 3 3 3 3 3 3 
0 0 0 0 0 0 0 0 0 10 5 5 19 19 19 19 19 19 19 9 3 3 3 3 2 5 2 3 3 3 3 10 3 3 3 3 3 3 3 3 3 3 3 3 3 3 3 3 3 3 
0 0 0 0 0 0 0 0 0 10 5 5 19 19 19 19 19 19 19 9 3 3 3 3 2 5 2 3 3 3 3 10 3 3 3 3 3 3 3 3 3 3 3 3 3 3 3 3 3 3 
0 0 0 0 0 0 0 0 0 10 5 5 5 19 19 19 19 19 19 9 3 3 3 3 2 5 2 3 3 3 3 10 3 3 3 3 3 3 3 3 3 3 3 3 3 3 3 3 3 3 
0 0 0 0 0 0 0 0 0 16 7 7 7 19 19 19 19 19 19 9 3 3 3 3 2 5 2 3 3 3 3 10 3 3 3 3 3 3 3 3 3 3 3 3 3 3 3 3 3 3 
5 5 5 5 5 5 5 5 5 5 5 5 5 5 5 5 5 5 5 5 5 5 5 5 5 5 5 5 5 5 5 5 5 5 5 5 5 5 5 5 5 5 5 5 5 5 5 5 5 5 
19 19 19 19 19 19 19 19 19 19 19 19 19 19 19 19 19 19 16 9 3 3 3 3 2 5 2 3 3 3 3 10 17 3 3 3 3 3 3 3 3 3 3 3 3 3 3 3 3 3 
19 19 19 19 19 19 19 19 19 19 19 19 19 19 19 19 19 19 19 9 3 3 3 3 2 5 2 3 3 3 3 10 19 3 3 3 3 3 3 3 3 3 3 3 3 3 3 3 3 3 
0 0 0 0 0 0 0 0 19 19 19 19 19 19 19 19 19 19 19 9 3 3 3 3 2 5 2 3 3 3 3 10 19 3 3 3 3 3 3 3 3 3 3 3 3 3 3 3 3 3 
0 0 0 0 0 0 0 0 0 0 0 19 19 19 19 19 19 19 19 9 3 3 3 3 2 5 2 3 3 3 3 10 19 3 3 3 3 3 3 3 3 3 3 3 3 3 3 3 3 3 
0 0 0 0 0 0 0 0 0 0 0 19 19 19 19 19 19 19 19 9 3 3 3 3 2 5 2 3 3 3 3 10 19 3 3 3 3 3 3 3 3 3 3 3 3 3 3 3 3 3 
0 0 0 0 0 0 0 0 0 0 19 19 19 19 19 19 19 19 19 11 12 12 12 12 12 5 12 12 12 12 12 13 19 3 3 3 3 3 3 3 3 3 3 3 3 3 3 3 3 3 
0 0 0 0 0 0 0 0 0 0 19 19 19 19 19 19 19 19 19 19 19 19 19 19 2 5 2 19 19 19 19 19 19 3 3 3 3 3 3 3 3 3 23 25 3 3 3 3 3 3 
0 0 0 0 0 0 0 0 0 19 19 19 19 19 19 19 19 19 19 19 19 19 19 19 2 5 2 19 19 19 19 19 19 3 3 3 3 3 3 3 3 3 26 27 3 3 3 3 3 3 
0 0 0 0 0 0 0 0 0 19 19 19 19 19 19 19 19 19 19 19 19 19 19 19 2 5 2 19 19 19 19 19 3 3 3 3 3 3 2 3 3 3 26 27 3 3 3 3 3 3 
0 0 0 0 0 0 0 0 0 19 19 19 19 19 19 19 19 19 19 19 19 19 19 19 2 5 2 19 19 19 19 19 3 3 3 3 3 3 3 3 2 3 26 27 3 3 3 3 3 3 
0 0 0 0 0 0 0 0 0 0 19 19 19 19 19 19 19 19 19 19 19 19 19 19 2 5 2 19 19 19 19 19 3 3 3 3 3 3 3 3 2 3 26 27 3 3 3 3 3 3 
0 0 0 0 0 0 0 0 0 0 0 0 0 0 0 0 0 19 19 19 19 19 19 19 2 5 2 19 19 19 19 19 3 3 3 3 3 3 3 3 3 3 26 27 3 3 3 3 3 3 
0 0 0 0 0 0 0 0 0 0 0 0 0 0 0 0 0 0 0 19 19 19 19 19 14 5 15 19 19 19 19 23 24 24 24 24 24 24 24 24 24 24 34 33 24 24 24 24 24 24 
0 0 0 0 0 0 0 0 0 0 0 0 0 0 0 0 0 0 0 0 0 0 0 19 10 5 9 2 2 2 2 26 21 21 21 21 21 21 21 21 21 21 21 21 21 21 21 21 21 21 
0 0 0 0 0 0 0 0 0 0 0 0 0 0 0 0 0 0 0 0 0 0 0 19 10 5 9 2 2 2 2 26 21 21 21 21 21 21 21 21 21 21 22 21 21 21 21 21 21 22 
0 0 0 0 0 0 0 0 0 0 0 0 0 0 0 0 0 0 0 0 0 0 0 19 10 5 9 2 2 2 2 26 21 22 21 21 21 22 22 21 21 21 21 21 21 21 21 22 21 21 
0 0 0 0 0 0 0 0 0 0 0 0 0 0 0 0 0 0 0 0 0 0 0 19 10 5 9 2 2 2 2 26 21 21 21 21 21 21 21 21 21 21 21 21 22 21 21 22 21 21 
0 0 0 0 0 0 0 0 0 0 0 0 0 0 0 0 0 0 0 0 0 0 19 19 10 5 9 2 2 2 2 26 21 21 21 22 21 21 21 22 21 21 21 21 21 21 21 21 21 21 
0 0 0 0 0 0 0 0 0 0 0 0 0 0 0 0 0 0 0 0 0 0 19 19 10 5 9 2 2 2 2 28 29 29 29 29 29 29 29 29 29 29 29 29 29 29 29 29 29 29 
0 0 0 0 0 0 0 0 0 0 0 0 0 0 0 0 0 0 0 0 0 0 19 19 10 5 9 2 2 2 2 2 2 2 2 2 2 2 2 2 2 2 2 2 2 2 2 2 2 2 
0 0 0 0 0 0 0 0 0 0 0 0 0 0 0 0 0 0 0 0 0 0 19 19 10 5 9 2 2 2 2 23 24 24 24 24 24 24 24 24 24 24 24 24 24 24 24 24 24 24 
0 0 0 0 0 0 0 0 0 0 0 0 0 0 0 0 0 0 0 0 0 0 19 19 10 5 9 2 2 2 2 26 21 21 21 21 21 21 21 21 22 21 21 21 21 21 21 21 21 21 
0 0 0 0 0 0 0 0 0 0 0 0 0 0 0 0 0 0 0 0 0 0 19 19 10 5 9 2 2 2 2 26 22 21 21 21 21 21 21 21 21 21 21 21 21 21 21 22 22 21 
0 0 0 0 0 0 0 0 0 0 0 0 0 0 0 0 0 0 0 0 0 0 19 19 10 5 9 2 2 2 2 26 21 21 21 22 21 21 21 21 21 21 21 21 21 21 22 21 21 21 
0 0 0 0 0 0 0 0 0 0 0 0 0 0 0 0 0 0 0 0 0 0 19 19 10 5 9 2 2 2 2 26 21 21 21 21 21 21 22 21 21 21 21 21 22 21 21 21 21 22 
